80
20
................................................................................
....#####.......................................................................
....#####.......................................................................
....#####.......................................................................
............................................###.................................
.............####...........................###.................................
......A......####........######################.................................
.............####........######################.................................
.............####........###....................................................
................................................................................
.....................................................########...................
.................#######.............................########...................
.................#######.............................########...................
.................#######.............................########...................
.................#######........########.................####...................
.................#######........########.................####..........G........
.................#######........########.................####...................
................................########........................................
................................########........................................
................................########........................................
